TTTTTTTTTTTTTTTTTTTT
TMMMTTTTTMMMMTTTTTTT
TMTMTTTTTMTTMTTTTTTT
TMTMTTTTTMTTMTTTTTTT
MMTMTTMMMMTTMTTTMMMB
TTTMTTMTTTTTMTTTMTTT
TTTMTTMTTTTTMTTTMTTT
TTTMTTMTTTTTMMMMMTTT
TTTMMMMTTTTTTTTTTTTT
TTTTTTTTTTTTTTTTTTTT