TTTTTTTTTTTTTTTTTTTTTTTTTTTTTTTTTTTTTTTT
TTTTTTTTTTTTTTTTTTTTTTTTTTTTTTTTTTTTTTTT
TTTTTTTTTTTTTTTTTTTTTTTTTTTTTTTTTTTTTTTT
TTTTTTTTTTTTTTTTTMMMMTTTTTTTTTTTTTTTTTTT
TTTTTTTTTTTTTTTTMMMTMMMTTTTTTTTTTTTTTTTT
TTTTTTTTTTTTTTTMMMTTTMMMMTTTTTTTTTTTTTTT
TTTTTTTTTTTTTTTMMTTTTTTTMMTTTTTTTTTTTTTT
TTMMMMMTTTTTTTTMMTTTTTTTMMTTTTTTTTTTTTTT
TTMTTTMTTTTTTTTMMTTTTTTTMMTTTTTTTTTTTTTT
MMMTTTMTTTTTTTTMMTTTTTTTMMTTTTTTTMMMMMMB
TTTTTTMTTTTTTTTMMTTTTTTTMMTTTTMMMMMTTTTT
TTTTTTMTTTTTTTTMMTTTTTTTTMTMMMMMMTTTTTTT
TTTTTTMMTTTTTMMMTTTTTTTTTMMMMMMTTTTTTTTT
TTTTTTTMMMMMMMMTTTTTTTTTTTTTTTTTTTTTTTTT
TTTTTTTTTTMMMMTTTTTTTTTTTTTTTTTTTTTTTTTT
TTTTTTTTTTTTTTTTTTTTTTTTTTTTTTTTTTTTTTTT
TTTTTTTTTTTTTTTTTTTTTTTTTTTTTTTTTTTTTTTT
TTTTTTTTTTTTTTTTTTTTTTTTTTTTTTTTTTTTTTTT
TTTTTTTTTTTTTTTTTTTTTTTTTTTTTTTTTTTTTTTT
TTTTTTTTTTTTTTTTTTTTTTTTTTTTTTTTTTTTTTTT