TMMMMMMMMTMMMMMMTMMMMMMMM
TTTTTMMMMTTTMMMMMTTTTTMMB
MMMMMMTTMMMMMTTTMMMTTMMMT
TMMMTTTTTTTTTMMMTTMTMTMMM
TTTMTTTMMMMMMMTMTTMTTMMMM
TTTMMMMMTMMTTTMMTTMTTMMTT
TTTTTMMTMTTMMMMTTMMTTMMTT
TTTTTTMTMTMMTTTMMMMTMMTTT
TTTTTTTMTMMMTTTMTTTMMTTTT
TTTTTTTMMMTTMMTMMMMMTTTTT
TTTTTTTMMMMMTTTTTTTTTTTTT
MMMMMMMMMTTMMMMMMMMMMMMMM
TTTTTTTTTTTTTMMMMMMMMMTTB