TTTTSMTMMTMMMMMMTMMMMMMMM
TTTTMMMMMTTTMMMMMTTTTTMMB
SMMMMMTTMMMMMTTTMMMTTMMMT
TMMMTTTTTTTTTMMMTTMTMTMMM
TTTMTTTMMMMMMMTMTTMTMMMMM
TTTMMMMMTMMTTTMMTTMTTMMTT
TTTTTMMTMTTMMMMTTMMTTMMTT
TTTTTTMMMTMMTTTMMMMTMMTTT
TTTTTTTTTMMMTMMMTTTMMTTTT
TTTTTTTMMMTTMMTMMMMMTTTTT
TTTTTTTMMMMMTTTTTTTTTTTTT
SMMMMMMMMTTMMMMMMMMMMMMMM
TTTTTTTTTTTTTMMMMMMMMMTTB