TTTTTTTTTTTTTTTTTTTTTTTTT
TMMMTMMMTTTMMTMTTTTTTTMTT
TMTMTMTMTMMMTTMMTMTMTMMMT
TMTMTMTMTMTMTMTMMMTMTMMMT
TMMMTMTMMMTMTMTMMMTMTMTMT
TMTMTMMMTMTMTMTMTMTMTMMMT
SMMMMMTMMMMMMMMMMMMMMMTMB
TMTMTMTMTMTMTMTMTMTMTMMMT
TMTMTMTMTMMMTMTMTMTMTMTMT
TMTMTMMMTMTMMMMMTMTMTMMMT
TMMMTTTTTMTTMTMTTTTMTTTMT
TTTMMMMMMMTTMTMTTMMMMMTMT
TTTTTTTTTTTTTTTTTTTTTTTTT